****************
**------------**
**------------**
**------------**
**------------**
**------------**
**------------**
**------------**
**---LLLLLL---**