****************
****************
**------------**
**------------**
**----LLLL----**
**----MMMM----**
**----HHHH----**
**------------**
**------------**