*--------------*
----------------
----------------
*----*----*----*
----------------
----------------
LLMMLLHHHHLLMMLL