----------------
------HHHH------
----HHHHHHHH----
---HHHHHHHHHH---
--HLLHHHHLLHHH--
--LLLLHHLLLLHH--
--MMLLHHMMLLHH--
-HMMLLHHMMLLHHH-
-HHLLHHHHLLHHHH-
-HHHHHHHHHHHHHH-
-HHHHHHHHHHHHHH-
-HHHHHHHHHHHHHH-
-HHHH-HHHH-HHHH-
--HH---HH---HH--