----------------
----------------
LLLLLLLLLLLLLLLL
LLLMLLLLLLLLHLLL
LLMMLLLLLLLLHHLL
LMMMLLLLLLLLHHHL
MMMMLLLLLLLLHHHH
LMMMLLLLLLLLHHHL
LLMMLLLLLLLLHHLL
LLLMLLLLLLLLHLLL
LLLLLLLLLLLLLLLL