----------------
H---------------
HM--------------
HML-------------
HMLH------------
HMLHM-----------
HMLHML----------
HMLHMLH---------
HMLHMLHM--------
HMLHMLHML-------
HMLHMLHMLH------
HMLHMLHMLHM-----
HMLHMLHMLHML----
HMLHMLHMLHMLH---
HMLHMLHMLHMLHM--
HMLHMLHMLHMLHML-
***************H