**********
*HHHHHHHH*
*HMMLLMMH*
**MMLLMM**
*HHLLLLHH*
***LLLL***