**********
HHHHLLHHHH
HHHLLLLHHH
HMMLLLLMMH
HMMLLLLMMH
HHHLLLLHHH
*HHHLLHHH*
**HHLLHH**
***HLLH***